~~~~~~~~~~~~~~~~~~~~~~~~~~~~~~~~~~~~~~~~
~..~.~~~~~~~~~~~~~~.......~~~~~....~~~~~
~..........~~~~~~~~~.....~~~~........~~~
~............~~~~~~............~~~~...~~
~...........~~~~~~~~......~~~..~~~~....~
~...............~......~..~~~~........~~
~.....................~~.~~~.........~~~
~~...........~~~....~~~~..~~~......~~~~~
~~~~........~~~~~..~~~~..~~~....~~~~~~~~
~~~~~~....~~~~~~~~~~~...~~...~~~~~~~~~~~
~~~......~~~~~~~~~~~..~~~.....~~~~~~~~~~
~~.........~~~~~~~~..~~...~~~..~~~~~~~~~
~....~~~....~~~~~~~..~~~~..~~~..~~~~~~~~
~~....~~~....~~~~~~~..~~~..~~..~~~~~~~~~
~~~....~~~...~~~~~~~~.....~~..~...~~~~~~
~~~~~....~~~~~~~~~~~~~~~~~~~~...~..~~~~~
~~~~~~~...~~~~~~~~~~~~~.....~~~~~~..~~~~
~~~~~......~~~~.~~~~~~.........~~..~~~~~
~~~~.........~..~~~~.....~~~~~....~~~~~~
~~~~~~.........~~..........~~~~~~~~~~~~~
~~~~~~~~.....~~~~~..........~~~~~~~~~~~~
~~~~~~~~~~..~~~~~~~~~...~~...~~~~~~~~~~~
~~~~~~~~~~~~~~~~~~~~~~~~~~~~~~~~~~~~~~~~
